

#######################################
# Syntax Coloring Map For RWS_NMEA
#######################################
# https://github.com/arduino/Arduino/wiki/Arduino-IDE-1.5:-Library-specification
#######################################
# Datatypes (KEYWORD1)
#######################################

Args	KEYWORD1
Comma	KEYWORD1
CommaCommand	KEYWORD1
Command	KEYWORD1
CommandError	KEYWORD1
CommandList	KEYWORD1
Dispatcher	KEYWORD1
FIFO	KEYWORD1
InputState	KEYWORD1
ItemOwner	KEYWORD1
LinkedItem	KEYWORD1
LinkedItemOwner	KEYWORD1
LinkedList	KEYWORD1
Option	KEYWORD1
OptionList	KEYWORD1
PlotDemo	KEYWORD1
PlotTask	KEYWORD1
PrintableItem	KEYWORD1
PrintableList	KEYWORD1
Repository	KEYWORD1
Responder	KEYWORD1
Shell	KEYWORD1
ShellBuffer	KEYWORD1
ShellHandler	KEYWORD1
ShellPlot	KEYWORD1
ShellStream	KEYWORD1
Task	KEYWORD1
Task_Buffer	KEYWORD1
Task_Comma	KEYWORD1
Task_OffsetString	KEYWORD1
Task_Printable	KEYWORD1
TaskList	KEYWORD1
TaskOwner	KEYWORD1
Timer	KEYWORD1
VirtualSerial	KEYWORD1

#######################################
# Methods and Functions (KEYWORD2)
#######################################

add	KEYWORD2
append	KEYWORD2
assign	KEYWORD2
available	KEYWORD2
availableForWrite	KEYWORD2
begin	KEYWORD2
buffer	KEYWORD2
c_str	KEYWORD2
capacity	KEYWORD2
check_connection	KEYWORD2
clear	KEYWORD2
comma_command	KEYWORD2
command	KEYWORD2
count	KEYWORD2
current	KEYWORD2
default_handler	KEYWORD2
demo	KEYWORD2
description	KEYWORD2
dispatch_buffer	KEYWORD2
dispatch_command	KEYWORD2
dispatch_offset_string	KEYWORD2
dispatch_printable_list	KEYWORD2
every_10ms	KEYWORD2
every_milli	KEYWORD2
every_second	KEYWORD2
every_tenth	KEYWORD2
finish	KEYWORD2
first	KEYWORD2
handler	KEYWORD2
init	KEYWORD2
is_empty	KEYWORD2
item	KEYWORD2
linked_item	KEYWORD2
linked_item_adopt	KEYWORD2
linked_item_pop	KEYWORD2
linked_item_push	KEYWORD2
lookup	KEYWORD2
name	KEYWORD2
next	KEYWORD2
pack754_32	KEYWORD2
pop	KEYWORD2
pop_and_return	KEYWORD2
prepare	KEYWORD2
printable	KEYWORD2
printable_count	KEYWORD2
printf	KEYWORD2
process_task	KEYWORD2
process_tasks	KEYWORD2
push	KEYWORD2
push_eol	KEYWORD2
read	KEYWORD2
repository_status	KEYWORD2
reset	KEYWORD2
respond_to_RSVP	KEYWORD2
return_to_owner	KEYWORD2
select	KEYWORD2
selection	KEYWORD2
set_default_handler	KEYWORD2
set_eol	KEYWORD2
set_handler	KEYWORD2
set_name	KEYWORD2
set_responder	KEYWORD2
shell_command	KEYWORD2
shell_notification	KEYWORD2
space	KEYWORD2
status	KEYWORD2
stop	KEYWORD2
stream_notification	KEYWORD2
sync_read_begin	KEYWORD2
sync_write_begin	KEYWORD2
sync_write_end	KEYWORD2
task	KEYWORD2
tick	KEYWORD2
tmp_buffer	KEYWORD2
unpack754_32	KEYWORD2
update	KEYWORD2
usage	KEYWORD2
write	KEYWORD2
write_char	KEYWORD2
write_eol	KEYWORD2

#######################################
# Instances (KEYWORD2)
#######################################


#######################################
# Constants (LITERAL1)
#######################################

ce_Okay	LITERAL1
ce_IncorrectUsage	LITERAL1
ce_UnhandledCommand	LITERAL1
ce_OtherError	LITERAL1
is_CC	LITERAL1
is_Start	LITERAL1
is_Discard	LITERAL1
is_Processing	LITERAL1
is_String	LITERAL1
